   @@@@@
 @@@###@
@DB@###@
@DBB###@
@DB@###@
@@@@###@
   @##D@
   @B#D@
    @@@