  @@@
 @###@
@#####@@
@###D###@
@######@
 @@@@@@