  @@@
 @###@
@B#B#@@@
@#B#####@
@###D##@
 @@@@@@