@@@@@@
@###B@
@#G##@
@**#B@
@**BB@
@@@@@@