 @@@@@@
@#BBB##@
@##BB##@
@*#**##@
@@@@@@#@
@DDDDD#@
 @@@@@@