@@@@@@
@###D#@ @@@@
@#B###@@@DB@
@###*######@
@#####@@@@@
@@@@@@