@@@@@@@@
@B@DDD#@
@B#@@#@
@B####@
@@@@@@