 @@@
@@#@@@
@#G##@
@####@
@#D@B@
@@@@@@