@@@@@@
@G###@
@####@
@#D#B@
@@@@@@