@@@@@@@@@@@@@
@Q@Q@Q@Q@Q@B@
@#@#@#@#@#@B@
@*@*@*@*@*@#@
@##########B@
@*@*@*@*@*@B@
@D@D@D@D@D@B@
@@@@@@@@@@@@@