 @@@@@
 @QQDB@@@
 @QPQ##B@
@@QQP*@@@
@*DQQ*@
@@@@@@@