 @@@@@
@#####@
@#B#B#@
@DD###@
 @@@@@