  @@@@
 @####@
@B#BB##@@@
@#B###D##@
@###D##DD@
 @@@@@@@@