 @@@@@@@
@B@##@D@
@B#B#DD@
@B@##@D@
 @@@@@@