@@@@@@
@B##B@
@g***@
@#***@
@#BB#@
@@@@@@