@@@@@@
@####@
@#G##@
@**##@
@**#B@
@@@@@@