@@@@@@@@@@
@@D@B#B##@
@DDDD@B##@
@@D@BBB##@
@@@@@@@@@@