@@@@@@@@@@@
@#@@@@@@@#@
@##G######@
@*********@
@****#****@
@D#######Q@
@@@@@B@@@@@
@@@@@@@@@@@