 @@@@@@
@*BBB##@
@##BB##@
@#***##@
@######@
@DDDDD#@
 @@@@@@