@@@@@@@@@@
@B*OBO*OB@
@*OBOBO*B@
@B*OBO*DB@
@@@@@@@@@@