@@@@@@
@G###@
@####@
@###B@
@@@@@@