@@@@@@@@@@
@g#######@
@########@
@###BB###@
@##QBB###@
@########@
@########@
@@@@@@@@@@