@@@@@@@@@@@
@##@@@@@##@
@#G#######@
@*********@
@****#****@
@D#######Q@
@@@@@B@@@@@
@@@@@@@@@@@