@@@@@@@@@@
@B@B@D@D@D@
@#B#BB###D@
@D@D@B@B@D@
 @@@@@@@@@@