 @@@@@@
@#BBB##@
@##BB##@
@######@
@@@@@@#@
@DDDDD#@
 @@@@@@