@@@@@@@@ @@@@@
@###*##@ @D#D@
@##*B*#@@@###@
@#**DB*####B#@
@##*B*@@@@###@
@###*#@  @##D@
@@@@@@   @@@@