@@@@@
@QQB@
@QQ#@
@QP#@
@DQ*@
@@@@@